5 8
S1 WE WE WE UG WS NL NL
S0 WE UG WS NS NS NL NL
S1 WE WN NS NS NS NL NL
S0 WE WE UG WN NS NL NL
S1 WE WE WE WE UG WE EG
0
