5 7
S1 WE WS NL NL NL NL
S0 WE UG WE WS NL NL
S1 WE WS NL NS NL NL
S0 WE UG WS UG WE EG
S1 WE WE UG WN NL NL
1
N :/levels/easy5.txt