9 10
S1 WE UG WS NL NL NL NL NL NL
S0 WE WE UG UG WE UG WE WE EG
S1 WE UG WE WE UG WN NL NL NL
S0 WE WN NL NL NS NL NL NL NL
S1 WE WE WS NL NS NL NL NL NL
S1 WE UG UG WE WN NL NL NL NL
S0 WE WN NL NL NL NL NL NL NL
S0 WE UG WE WE WS NL NL NL NL
S0 WE WE UG WE UG WE WE WE EG
1 2