6 9
S1 WE UG UG WS NL NL NL NL
S1 WE WN NL NS NL NL NL NL
S1 WE UG UG UG WE WE WS NL
S1 WE WN NL NL NL UG UG EG
S1 WE WS NL UG UG WN NL NL
S1 WE UG UG WN NL NL NL NL
0