7 9
S1 WE WS NL NL NL NL NL NL
S1 WE UG WE UG WS NL NL NL
S1 WE WE WE WE UG WS NL NL
NL NL NL NL NL NL UG WE EG
S1 WE UG WE WS NL NS NL NL
S1 WE WS NL UG WE WN NL NL
S1 WE UG UG WN NL NL NL NL
0
S 0 1 0
S 1 1 0
G 0 1
G 1 2
S 2 1 2
G 2 3
E 3 0
S 3 1 4
G 4 5
G 5 3
S 4 1 6
S 5 1 6
G 6 7
G 7 5
N :/levels/hard2.txt
