9 10
S1 WE UG WS NL NL NL NL NL NL
S0 WE WE UG UG WE UG WE WE EG
S1 WE UG WE WE UG WN NL NL NL
S0 WE WN NL NL NS NL NL NL NL
S1 WE WE WS NL NS NL NL NL NL
S1 WE UG UG WE WN NL NL NL NL
S0 WE WN NL NL NL NL NL NL NL
S0 WE UG WE WE WS NL NL NL NL
S0 WE WE UG WE UG WE WE WE EG
1 0
S 0 1 0
G 0 1
S 1 0 1
G 1 2
G 2 3
E 3 0
S 2 1 4
S 3 0 4
G 4 5
G 5 3
G 6 7
S 4 1 7
S 5 1 6
S 6 0 6
G 7 5
S 7 0 8
S 8 0 9
G 8 10
G 9 10
E 10 1
N :/levels/hard3.txt
