8 10
S0 WE UG WE WS NL NL NL NL NL
S0 WE UG UG UG WE WE WE WS NL
S1 WE UG WE WE WE UG UG UG EG
S1 WE UG UG WE WE WN NS NL NL
S1 WE WS NL NL NL NL NS NL NL
S1 WE UG WS NL NL NL NS NL NL
S0 WE WE UG UG WS NL NS NL NL
S0 WE UG WE WE UG UG WN NL NL
1
N :/levels/hard5.txt
