7 9
S1 WE WS NL NL NL NL NL NL
S1 WE UG WE UG WS NL NL NL
S1 WE WE WE WE UG WS NL NL
NL NL NL NL NL NL UG WE EG
S1 WE UG WE WS NL NS NL NL
S1 WE WS NL UG WE WN NL NL
S1 WE UG UG WN NL NL NL NL
0
N :/levels/hard2.txt