8 8
S1 WE WS NL NL NL NL NL
S0 UG UG WS NL NL NL NL
S1 WE WE UG WE WS NL NL
S0 WE WE WE WS NS NL NL
S1 WE WE WE UG UG UG EG
S1 WE WE UG WE WE WN NL
S0 WE UG WN NL NL NL NL
S0 WE WN NL NL NL NL NL
1
N :/levels/hard1.txt