6 9
S1 WE WS NL NL NL NL NL NL
S0 WE UG WE UG WS NL NL NL
S1 WE WE WE WN UG WS NL NL
S0 WE WE WS NL NL UG WE EG
S1 WE WS NS NL NL NS NL NL
S0 WE UG UG WE UG WN NL NL
0
N :/levels/medium5.txt