5 7
S1 UG WE WS NL NL NL
S1 UG WE UG WS NL NL
NL NL NL NL UG WE EG
S1 WE WS NL NS NL NL
S1 WE OR UG WN NL NL
0