6 9
S1 WE WS NL NL NL NL NL NL
S1 WE UG WS NL NL NL NL NL
S0 WE WE UG WS NL NL NL NL
S0 WE WE WE UG WS NL NL NL
S0 WE WE WE WE UG WS NL NL
S1 WE WE WE WE WE UG WE EG
1