5 7
S1 WE WE UG WE WE EG
NL NL NL NL NL NL NL
NL NL NL NL NL NL NL
NL NL NL NL NL NL NL
S0 WE WE UG WE WE EG
0 1
S 0 1 0
S 1 0 1
E 0 0
E 1 1
N :/levels/tutorial5.txt
