8 7
S1 WE WE WS NL NL NL
S1 WE WE UG WE WE EG
S1 WE WE WS NL NL NL
S0 WE WE UG WE WE EG
S0 WE WE WS NL NL NL
S1 WE WE UG WE WE EG
S0 WE WE WS NL NL NL
S0 WE WE UG WE WE EG
0 1 1 1
S 0 1 0
S 1 1 0
S 2 1 1
S 3 0 1
S 4 0 2
S 5 1 2
S 6 0 3
S 7 0 3
E 0 0
E 1 1
E 2 2
E 3 3